##################################################
# #    #      #   #    # #  ###    #        #    #
# # ##   # # #  # # ##    #  #  ##   ### ## # ## #
# #   # #   #  #      # #  #   # ####   #   ## # #
#  ##  #  #   ## ##### #  # # #       ##  ##     #
##   #  # # # #      # # #    # ## ####  #   # # #
## #  #  #   ##      # # # ## # ##      #  ##   ##
#  ##  #  ##  #      #   #  # #   # #### # #  #  #
# #  #  #  ####      # ## ##  # #  #   #   ### ###
# # # #  #    ########       # # #  # ## #       #
# #   # # ###    ## ## #### #     # #     ### ## #
#   # #     ####    #     ##  ###   ## ###   # # #
## #   # # #    ## ##     #  ##  # #       # # # #
#   #####  # # #    #     # ##  #  # ## ###    # #
####   #  ## # # # ##     # #  # #  #  #   # ##  #
#    # # #   #  ##  #     #   #   # ##   #  #   ##
# ###  #  # # #   # #     ## ### ##   # ###   ## #
# #   #  ##   ## #  ########   #   ## # #### #   #
#  # ###    ##   # #   #   #   # ##   #  ##  # # #
## #  ### ##   # #   # # # #   #    ## #   ##  # #
#  ##  #   # ##  ## ## ##  #   # # #    ##  # ## #
# # ##  # #   ###   #     ##   # ## # #  ##   #  #
# #   # #  ##   # ##  # # ######       #  # ##  ##
#  ##    #   ## # # ### #      #######  #  #   ###
## ## # # ##### #      ##      #      # # #  #  ##
#    #  #    #   # # #  #      #### #  #   #  #  #
# ##  #   ##   ###  # # #      #   # # # ## #  # #
#  ##  # #   ##   ##    ######## # #   #     # ###
##  # #  ####   #  # ###   #     # # #  #### #   #
# # #  ##     ## #   #   #  ### #  # # #   # # # #
#  #  #   ####    ###  #  #   #  #  #    ### # # #
##   #  ##     ##     #  ## #  #  #   # #    # # #
#  #  #  # ### #### ####   # #  #  #### # #### # #
# #  # # #   #    #   # ## # ##   #    ## #   #  #
# # #  #  ## #    # # # ##    # # # ## #  # #   ##
# #   ###   ##    # # #   # # #  #   #   #  ###  #
##  #  # ##  #    ##  # #  #  # #  #  # #  #   # #
#  ###   #  ##    #  # ### # ###  ###  #  #  # # #
# # # # #  ######## #   #  #  #  #####   #  ##   #
# #   # # ### #  #    # # ###   #########  #  # ##
# # #   #  #   #   # #     # # ##         # #  # #
# # # ### # ##  # #  # ### #  # #     # ##   #   #
#  ##   #   # #  #  ##   # # #  #     #    # ## ##
##  #   ## #    #  ###   #     ##     # ###   #  #
# # #   ##   # #  # ##   # #### #     ##   ## # ##
#   #   # ### #  #   #   #    # #######  #    #  #
# ####### #    #  ## #   #    # #    # # # ### # #
#      #   # # # #   #   #    #   ###     #    # #
# # ##   #   #     # #####    # #     # #   ##   #
##################################################

